########################
#.....#....#c..........#
#.....#....###.........#
#.....#....#...........#
#...p.#....#...........#
#.....#....#...........#
####..##..##...........#
#......................#
#....................k.w
#.................kkk..#
#..............p..kbk..#
########################