########################
#.....#....#cd.........#
#.....#....###.........#
#.....#....#...........#
#@..d.#....#...........#
#.....#....#...........#
####..##..##...........#
#......................#
#.....................N#
#......................#
#..............d...#...#
########################